10 10
1111111111
1000000001
1000000001
1000000001
1000000001
1001010101
1000000001
1001010101
1000000001
0000000000