10 10
1111111111
1EP0000001
1000000001
1000000001
1000000001
1001010101
1000000001
1001010101
1000000001
1111111111