10 10
1111111111
1000000001
1000000001
1000000001
1001111111
1000111111
1000000001
1000000001
1111111111
1111001111
1111111111
1111111111
2222222222
2222222222
2222222222
0000000000

